Список всех команд:
Для работы с файлами:
* load имя_файла - загрузить текст из файла
* save имя_файла - сохранить текст в файл
Команды вывода текста
* show - просто текст
* showrev - в обратном порядке следования строк
* showfirstworlds - только первые слова строк
* shownonempty - без пустых строк
* showupper - с капитализацией всех символов
* showupfirst - c капитализацией символов после пробела
* showodd - только нечетные строки
* showreveven - в обратном порядке без нечетных строк
* showdigitsonly - только цифры
* showalphaonly - опуская небуквенные символы
* showclassified - с заменой всех буквенные символов звездочками
* shownumspaces - вывод числа пробелов в каждой строке
* showtrimmedfromstart - без ведущих пробелов
* showlastnonspace - только последние непробельные символы строк
* showwordbeginnings - только буквенные символы, перед которыми пробел или начало строки
Команды перемещения курсора, вывода текста и изменения строк
* m номер_строки позиция - в новую позицию
* mcb - на один символ влево
* mwef - в конец текущего слова
* mwbb - в начало текущего слова
* mlb - в начало строки
* mle - в конец строки
* mp позиция - в новую позицию в текущей строке
* mnlb - в начало следующей строки
* mklb номер - в начало заданной строки
* ple - часть строки от курсора до конца строки
* plb - часть строки от начала до курсора
* rch - удаление одного символа справа от курсора
* rle - удаление всех символов от курсора до конца строки
* i строка - вставка строки от курсора
* y строка - замена строки от курсора и до конца заданной строкой
Команды работы со строками
* rt - удаление последней строки
* rn номер - удаление строки с заданным номером
* rc - удаление текущей строки
* r1e - удаление первой пустой строки
* r1ne - удаление первой непустой строки
* j - объединение строки с курсором со следующей
* p номер текст - вставка новой строки после строки с заданным номером
* pn текст - вставка новой строки после текущей
* p1 текст - вставка новой строки перед первой
* s - разделения текущей строки на две по позиции курсора
* cn - перемещения текущей строки после следующей
* cp - перемещения текущей строки перед предыдущей
* cb - перемещения текущей строки в начало текста
* ce - перемещения текущей строки в конец текст
